32
22
21 23 24 24 24 21 24 24 24 21 21 21 21 21 24 24 24 24 24 23 23 23 21 21 21 21 21 21 21 21 21 21 
24 23 24 24 21 24 24 1 21 21 21 2 0 23 24 23 24 0 23 23 23 0 0 1 21 21 2 1 21 2 0 21 
24 24 21 24 23 24 0 0 0 0 0 0 0 23 24 0 23 0 0 23 23 0 0 0 0 0 0 0 0 0 0 6 
21 2 21 23 0 0 0 0 0 0 0 0 0 23 0 0 0 0 0 23 0 0 0 0 0 0 0 0 0 0 0 6 
21 2 24 0 0 0 0 0 0 0 0 0 0 23 0 0 0 0 0 0 0 0 0 0 0 0 0 0 0 1 21 21 
21 2 0 0 0 0 0 0 1 21 21 2 0 0 0 0 0 0 0 0 0 0 0 0 0 0 1 21 21 21 21 21 
21 2 0 0 0 0 0 23 21 23 21 2 0 0 0 0 0 0 0 0 0 0 0 0 0 1 21 21 21 24 24 21 
21 2 0 0 0 0 0 0 23 23 0 3 22 4 0 0 0 0 0 0 0 0 0 0 0 24 24 23 23 23 24 21 
7 2 0 0 0 0 0 0 0 0 0 0 0 0 0 0 0 0 1 21 21 21 2 0 0 0 24 0 23 23 24 24 
7 2 0 0 0 0 0 0 0 0 0 0 0 0 1 21 2 0 0 0 0 21 2 0 0 0 0 0 23 0 23 24 
22 22 4 0 0 0 0 0 0 0 0 0 0 0 0 0 0 0 0 0 0 0 0 0 0 0 0 0 23 0 0 24 
21 21 24 24 0 0 0 0 0 0 0 1 21 21 2 0 0 0 0 0 0 0 0 0 0 0 0 0 0 0 0 24 
21 21 21 21 2 0 0 0 0 0 0 1 21 0 0 0 0 0 0 0 0 0 0 0 0 0 0 0 0 0 1 21 
21 21 21 2 0 0 0 0 0 0 1 21 21 25 22 30 23 23 23 0 0 0 0 0 0 23 0 0 0 0 1 21 
21 21 2 0 0 0 0 0 0 0 1 21 21 2 0 0 0 0 23 23 23 0 0 0 23 23 0 0 0 0 1 21 
21 21 2 0 0 0 0 0 0 24 24 21 21 2 0 0 0 0 0 0 0 0 24 23 23 23 23 0 0 0 1 21 
21 21 2 0 0 0 0 24 24 24 21 21 2 0 0 0 0 0 0 0 0 0 0 24 23 23 0 0 0 0 1 21 
21 2 0 0 0 0 0 0 24 24 0 0 0 0 0 0 0 0 0 0 0 0 0 0 23 23 0 23 0 0 1 21 
21 2 0 24 0 0 0 0 0 0 0 0 0 0 0 0 0 0 0 0 0 0 0 0 24 0 23 0 0 0 1 21 
21 2 0 23 0 0 0 0 0 0 0 0 0 0 0 0 0 0 0 0 0 0 0 24 23 23 24 23 0 0 1 21 
21 2 22 23 23 0 0 0 0 0 0 0 0 0 0 0 0 0 0 0 0 0 24 23 23 21 24 24 27 22 22 21 
22 22 26 25 22 22 22 22 22 22 22 22 22 22 22 22 22 22 22 22 22 22 30 23 27 22 22 22 22 21 25 22 
