62
21
23 23 23 23 23 23 23 23 23 23 23 32 32 32 32 32 32 32 21 21 21 21 21 32 32 32 23 23 23 23 23 23 23 23 23 23 23 23 23 23 23 23 23 23 23 23 23 23 23 23 23 23 23 23 23 23 23 23 23 23 23 23 
23 0 0 0 0 0 0 0 0 0 0 0 0 0 23 23 23 24 21 21 21 24 24 23 23 23 23 23 23 0 0 0 23 23 23 0 0 0 0 0 0 0 0 0 0 0 0 0 23 23 23 23 23 23 23 23 23 23 23 23 23 23 
23 0 0 0 0 0 23 23 0 0 0 0 0 0 0 0 0 6 21 21 24 23 23 23 0 23 23 23 23 0 0 0 0 23 23 24 0 0 0 0 0 0 23 0 0 0 0 0 0 23 23 0 0 0 23 23 23 23 23 23 23 23 
23 0 0 0 0 0 23 23 0 0 0 0 0 0 0 0 0 6 21 24 23 23 23 0 0 0 0 0 0 0 0 0 0 0 23 23 23 23 23 23 23 23 23 0 0 0 0 0 0 23 23 0 0 0 0 23 23 23 0 23 23 23 
23 0 0 0 23 23 23 23 23 0 0 0 0 0 0 0 22 23 23 23 23 23 23 0 0 0 0 0 0 0 0 0 0 0 0 0 23 23 23 23 23 23 23 23 0 0 0 0 0 23 23 0 0 0 0 23 23 23 0 0 23 23 
23 23 23 23 23 0 0 0 0 0 0 0 0 0 23 23 23 0 0 0 0 0 0 0 0 0 0 0 23 23 23 0 0 0 0 0 0 0 0 23 23 23 23 23 0 0 0 0 0 0 23 0 0 0 0 0 23 0 0 0 0 23 
23 23 23 0 0 0 0 0 0 23 0 0 0 0 0 0 23 23 0 0 0 0 0 0 0 0 23 23 23 23 23 23 0 0 0 0 0 0 0 0 23 23 23 23 23 0 0 0 0 0 0 0 0 0 0 0 23 0 0 0 0 23 
23 0 0 0 0 0 0 0 0 0 0 0 0 0 0 0 0 23 23 23 23 23 23 23 0 0 0 0 23 23 23 23 0 0 0 0 0 0 0 0 23 23 23 23 23 23 0 0 0 0 0 0 0 0 0 0 0 0 0 0 0 23 
23 0 0 0 0 0 23 23 0 0 0 0 23 23 0 0 0 0 0 0 23 23 23 23 0 0 0 0 0 0 0 23 23 0 0 23 23 0 0 0 0 23 23 23 23 23 0 0 0 0 0 0 0 0 0 0 0 0 0 0 0 23 
23 0 0 0 23 23 23 23 23 0 0 0 0 23 23 23 0 0 0 0 0 0 0 0 23 23 0 0 0 0 0 0 0 0 0 23 23 23 23 23 0 0 0 23 23 23 23 0 0 0 0 23 0 0 0 0 0 0 0 0 23 23 
23 0 0 23 0 0 23 23 23 23 0 0 0 0 0 23 23 0 0 0 0 0 0 0 0 23 23 0 0 0 0 0 0 0 0 23 23 23 23 23 23 23 0 0 0 23 23 23 0 0 0 0 0 0 0 0 0 0 0 23 23 23 
23 0 0 0 0 0 0 23 23 23 23 0 0 0 0 0 0 23 23 0 0 0 0 0 0 0 0 23 0 0 0 0 0 0 0 0 23 23 23 23 23 23 0 0 0 0 0 0 0 0 0 0 0 0 23 23 23 23 23 23 23 23 
23 23 0 0 0 0 0 0 23 23 23 23 0 0 0 0 0 0 23 23 23 23 0 0 0 0 0 0 0 0 0 0 0 0 0 0 0 23 23 23 23 23 23 0 0 0 0 0 0 0 0 0 0 23 23 23 23 23 23 23 23 23 
23 23 0 0 0 0 23 23 23 23 23 0 0 0 0 0 23 23 23 23 23 23 23 23 23 0 0 0 0 0 0 0 0 0 0 0 0 0 0 23 23 23 23 23 23 23 0 0 0 0 0 0 0 0 0 0 23 23 23 23 23 23 
23 0 23 0 0 23 24 24 23 23 0 0 0 0 23 23 23 23 24 24 24 24 23 23 23 23 0 0 0 0 0 0 0 0 0 0 0 0 0 0 0 23 23 23 23 23 0 0 0 23 0 0 0 0 0 0 0 0 23 23 23 23 
23 0 0 0 0 23 24 23 23 0 0 0 0 0 23 23 23 23 24 24 24 23 23 23 23 23 23 0 0 0 0 0 0 23 0 0 0 0 0 0 0 23 23 23 23 0 0 0 23 23 23 0 0 0 0 0 0 0 23 23 23 23 
24 23 23 23 23 23 23 23 0 0 0 0 0 23 23 23 0 23 23 23 23 23 0 0 23 23 23 0 0 0 0 23 23 23 0 0 0 0 0 0 0 0 23 23 0 0 0 23 23 23 0 0 0 0 0 0 0 23 23 23 23 23 
23 23 23 23 0 0 0 0 0 0 23 23 23 0 0 0 23 23 23 23 23 0 0 0 23 23 0 0 0 0 23 23 23 23 23 0 0 0 0 0 0 0 0 0 0 0 0 23 23 23 23 23 0 0 0 0 0 23 23 23 23 23 
7 0 0 0 0 0 0 0 0 23 0 0 0 0 0 0 0 0 0 0 0 0 0 0 0 0 0 0 0 23 24 24 24 23 23 23 0 23 23 0 0 0 0 0 0 0 23 23 23 23 23 23 23 23 0 0 0 23 23 23 23 23 
7 0 0 0 0 0 0 0 0 0 0 0 0 0 23 0 0 0 0 0 0 0 0 0 0 0 0 0 23 24 24 24 24 24 23 23 23 23 23 23 0 0 23 23 23 23 23 23 23 23 23 23 23 23 23 23 23 23 23 23 23 23 
22 22 22 28 23 23 23 23 23 23 23 23 23 23 23 23 23 23 23 23 23 23 23 23 23 23 23 23 23 24 24 23 24 24 24 24 23 23 23 23 23 23 23 23 23 23 23 23 23 23 23 23 23 23 23 23 23 23 23 23 23 23 
