19
11
23 23 23 23 23 23 23 23 23 23 23 23 23 23 23 23 23 23 23 
23 0 0 0 0 0 0 0 0 23 23 23 23 23 23 23 23 23 23 
23 0 0 0 0 0 0 0 0 0 0 0 0 0 23 23 23 23 23 
23 0 0 0 0 0 0 0 0 0 0 0 0 0 0 23 23 23 23 
23 0 0 0 0 0 0 0 0 0 0 0 0 0 0 0 0 23 23 
23 0 0 0 0 0 0 0 0 0 0 0 0 0 0 0 0 23 23 
7 0 0 0 0 0 0 0 0 0 0 0 0 0 0 0 0 23 23 
7 0 0 0 0 0 0 0 0 0 0 0 0 0 0 0 0 0 23 
23 23 0 0 0 0 0 0 0 0 0 0 0 0 0 0 0 0 6 
23 23 23 0 0 0 0 0 0 0 0 0 0 0 0 0 0 0 6 
23 23 23 23 23 23 23 23 23 23 23 23 23 23 23 23 23 23 23 
