32
22
23 23 23 23 23 23 23 23 23 23 23 23 23 23 23 23 23 23 23 23 23 23 23 23 23 23 23 23 23 23 23 23 
23 0 0 0 0 21 24 24 23 23 0 0 0 0 0 0 0 0 0 0 0 0 0 0 0 0 0 0 0 0 0 23 
23 0 0 0 21 5 24 23 0 0 0 0 0 0 0 0 0 0 0 0 0 0 0 0 0 0 0 0 0 0 0 23 
23 0 0 0 21 5 0 0 0 0 0 0 0 0 0 0 0 0 0 0 0 0 0 0 0 0 23 23 23 23 0 23 
23 0 0 0 24 24 0 0 0 0 0 0 0 0 0 0 0 0 0 0 0 0 0 0 0 23 23 0 0 0 0 6 
23 0 0 0 24 23 0 0 0 0 0 0 0 0 0 0 0 0 23 23 23 23 23 23 23 23 23 0 0 0 0 6 
23 0 0 24 23 23 23 23 23 0 0 0 0 0 0 0 23 23 23 23 23 23 23 23 23 23 0 0 0 3 22 22 
23 23 23 23 23 23 23 0 0 0 0 0 0 0 0 0 0 0 0 0 0 0 0 0 0 0 0 0 0 0 0 23 
23 23 23 23 23 23 0 0 0 0 23 23 23 23 0 0 0 0 0 0 0 0 0 0 0 0 0 0 0 0 0 23 
23 23 23 23 0 0 0 0 0 0 0 23 23 0 0 0 0 0 0 0 0 0 0 0 0 0 0 0 0 0 0 23 
23 23 23 0 0 0 0 0 0 0 0 0 0 0 0 0 23 23 0 0 0 0 0 0 0 0 0 0 0 0 23 23 
23 0 0 0 0 0 0 0 0 0 0 0 0 0 0 23 23 23 0 0 0 0 0 23 23 0 0 0 0 23 23 23 
23 0 0 23 23 23 23 23 0 0 0 0 0 0 0 23 23 23 23 23 0 0 0 0 0 0 0 0 0 23 23 23 
23 0 0 0 23 0 23 23 23 23 23 0 0 0 0 0 23 23 23 0 0 0 0 0 0 0 0 0 23 23 0 23 
23 0 0 0 0 0 0 23 23 23 23 23 0 0 0 0 0 23 0 0 0 0 0 0 23 23 0 0 23 0 0 23 
23 0 0 0 0 0 0 0 23 23 23 23 0 0 0 0 0 0 0 0 0 0 0 0 0 23 23 0 0 0 23 23 
23 0 0 0 0 0 0 0 0 0 0 0 0 0 0 0 0 0 0 0 23 0 0 0 0 0 23 23 0 0 23 23 
23 0 0 0 0 0 0 0 0 0 0 0 0 0 23 23 0 0 0 23 23 0 0 0 0 0 0 23 0 0 23 23 
23 0 0 0 0 0 0 0 0 0 0 0 23 23 23 23 23 0 23 23 0 0 0 0 23 23 23 23 23 23 23 23 
7 0 0 0 0 0 0 0 0 0 0 23 23 23 23 23 23 23 23 0 0 0 0 23 23 23 23 23 23 23 23 23 
7 0 0 0 0 0 0 23 23 23 23 23 23 23 23 0 0 0 0 0 23 23 23 23 23 23 23 23 23 23 23 23 
22 22 28 23 23 23 23 23 23 23 23 23 23 23 23 23 23 23 23 23 23 23 23 23 23 23 23 23 23 23 23 23 
