31
21
32 32 32 32 32 32 32 32 32 32 32 32 32 23 23 23 23 23 23 23 23 23 23 23 23 23 23 23 23 23 23 
23 23 23 0 0 0 0 0 0 0 0 0 0 0 0 0 0 0 0 0 0 0 0 23 23 23 23 23 23 23 23 
23 23 23 23 23 0 0 23 23 23 23 23 23 0 0 0 0 0 0 0 0 0 0 0 0 0 0 0 0 0 23 
23 23 23 23 23 23 23 23 23 23 23 23 23 23 23 0 0 0 0 0 0 0 0 0 0 0 0 0 0 0 23 
23 23 23 23 23 23 23 23 0 0 0 0 23 23 23 23 0 0 0 0 0 0 0 0 0 0 0 0 0 0 6 
23 23 23 23 0 0 0 0 0 0 0 0 0 0 23 23 23 23 23 23 23 23 0 0 0 0 0 0 0 0 6 
23 23 0 0 0 0 0 0 0 0 0 0 0 0 0 0 0 0 0 0 0 0 0 0 0 0 0 23 27 22 22 
23 0 0 0 0 0 0 0 0 0 0 0 0 0 0 0 0 0 0 0 0 0 0 0 0 0 0 0 0 23 23 
23 0 0 0 0 0 0 0 0 0 0 0 0 0 0 0 0 0 0 0 0 0 0 0 0 0 23 0 0 0 23 
23 0 0 0 0 0 0 0 23 23 23 23 0 0 0 0 0 0 0 0 0 0 0 0 0 23 23 23 23 0 23 
23 0 0 0 0 0 0 0 0 23 23 23 23 23 23 0 0 0 0 0 0 0 23 23 23 23 0 23 23 23 23 
23 23 23 23 0 0 0 0 0 8 8 23 23 23 23 23 0 0 0 0 0 0 0 0 0 0 0 0 23 0 23 
24 23 23 23 23 0 0 0 0 0 0 8 8 8 23 23 23 23 23 0 0 0 0 0 0 23 23 0 0 0 23 
24 24 23 23 23 23 0 0 0 0 0 0 0 0 8 8 8 23 23 23 23 0 0 0 23 23 23 23 23 23 23 
24 24 23 23 23 23 23 23 0 0 0 0 0 0 0 0 0 8 8 23 23 23 0 0 0 0 0 23 23 23 23 
23 23 23 8 8 8 8 23 23 23 0 0 0 0 0 0 0 0 0 23 23 23 23 23 0 0 0 0 23 23 23 
23 23 8 0 0 0 0 8 8 23 23 23 23 23 0 0 0 0 0 8 8 23 23 23 23 0 23 23 23 23 23 
23 8 0 0 0 0 0 0 0 8 8 8 8 23 23 23 23 0 0 0 0 8 23 8 23 23 23 23 23 23 23 
7 0 0 0 0 0 0 0 0 0 0 0 0 8 8 8 8 0 0 0 0 0 8 0 8 23 23 8 8 8 23 
7 0 0 0 0 0 0 0 0 0 0 0 0 0 0 0 0 0 24 0 0 0 0 0 0 8 8 0 0 23 23 
22 22 22 28 23 23 23 23 23 23 23 23 23 23 23 23 24 24 23 23 23 23 23 23 23 23 23 23 23 23 23 
