27
26
21 21 21 21 21 23 21 21 21 21 21 21 21 21 21 21 21 21 21 21 21 21 21 21 21 21 21 
23 23 21 21 21 23 21 21 23 21 21 21 21 21 21 21 24 24 21 21 21 21 2 0 0 6 21 
21 23 23 0 21 21 23 23 24 24 21 21 21 21 0 0 0 24 21 21 2 0 0 0 0 6 21 
23 23 8 0 24 23 21 21 23 23 21 21 23 23 0 21 2 21 21 2 0 0 0 0 0 21 21 
23 0 0 0 0 23 24 21 21 21 21 21 21 23 23 21 2 1 21 2 0 0 0 0 23 31 21 
5 0 0 0 0 0 23 0 0 0 0 0 21 21 21 21 2 0 0 0 0 0 0 0 0 24 21 
24 0 0 0 0 0 0 0 0 0 0 0 0 0 21 21 2 0 0 0 0 22 22 22 0 23 21 
23 23 0 0 0 0 0 0 0 0 0 0 0 0 0 0 0 0 0 0 21 21 23 32 0 23 21 
23 24 23 23 0 0 0 23 0 0 0 0 0 0 0 0 0 0 0 0 0 21 21 23 0 1 21 
21 21 21 31 21 2 0 23 23 0 0 0 0 0 0 0 0 0 21 21 0 0 21 0 0 1 21 
21 21 31 21 33 23 23 23 23 0 0 0 0 0 0 0 0 21 21 0 0 0 21 0 0 1 21 
21 21 21 21 21 21 23 8 8 1 21 21 21 2 0 0 0 0 21 0 0 0 0 0 0 1 21 
21 21 21 21 32 32 23 0 0 0 0 24 31 22 4 0 0 0 0 0 0 0 0 0 0 1 21 
21 21 21 21 8 23 8 0 0 0 0 0 23 32 0 0 0 0 0 0 0 0 0 0 0 31 21 
21 21 21 0 0 8 0 0 0 0 0 0 8 8 3 22 22 22 22 22 4 0 0 23 23 23 32 
21 21 2 0 0 0 0 0 0 0 0 0 0 0 0 0 0 0 0 0 0 0 23 8 8 8 24 
21 21 2 0 0 0 0 0 0 0 0 21 0 0 0 0 0 0 0 0 0 0 8 0 0 0 21 
21 21 2 0 0 0 0 0 0 21 21 21 0 0 0 0 3 22 22 22 22 22 22 22 0 0 21 
21 21 2 0 0 0 0 0 0 0 0 0 0 0 21 21 21 0 21 24 24 21 0 0 0 0 21 
21 7 0 0 0 23 23 0 0 0 0 0 0 0 0 0 0 0 24 24 0 0 0 0 0 21 21 
21 7 0 0 0 0 23 23 0 0 0 0 0 0 0 0 0 0 0 23 0 0 0 0 0 0 21 
21 21 21 2 0 0 0 0 0 0 0 0 1 21 21 2 0 0 0 0 0 0 21 0 0 1 21 
21 21 21 23 23 0 0 0 0 0 0 1 21 21 2 0 3 22 0 0 0 0 0 0 0 1 21 
21 21 21 21 21 23 0 0 0 0 1 21 21 21 2 0 22 32 0 0 0 0 0 0 1 21 21 
32 32 31 21 21 21 21 21 21 21 21 21 21 21 2 0 32 27 22 4 0 0 1 21 21 21 24 
24 24 24 32 32 31 21 21 21 21 21 21 21 21 21 21 21 21 21 21 21 21 21 21 21 24 24 
