28
10
21 21 21 21 21 21 21 21 21 21 21 21 21 21 21 23 23 21 21 21 23 21 23 21 21 21 21 21 
21 0 0 0 23 23 0 0 0 0 0 0 0 0 21 21 23 23 21 23 23 23 21 0 0 0 0 21 
21 0 0 0 23 0 0 0 0 0 0 0 0 0 0 0 0 23 23 23 23 0 0 0 0 0 0 21 
21 0 0 0 0 0 0 0 0 0 0 0 0 0 0 0 0 0 23 23 0 0 0 0 0 0 0 21 
21 0 0 0 0 0 0 0 0 0 0 0 0 0 0 0 0 0 23 0 0 0 0 0 0 0 0 21 
21 0 0 0 0 0 0 0 0 0 0 0 0 0 0 0 0 0 0 0 0 0 0 0 0 0 0 21 
21 0 0 0 0 0 0 0 0 0 0 0 0 0 0 0 0 0 0 0 0 0 0 0 0 0 0 21 
7 0 0 0 0 0 0 0 0 0 0 0 0 0 0 0 0 0 0 0 0 0 0 0 0 0 0 6
7 0 0 0 0 0 3 22 22 22 22 22 22 22 4 0 0 0 0 0 0 0 0 0 0 0 0 6 
21 22 22 22 22 22 22 26 23 23 23 23 21 25 22 22 22 22 22 22 22 22 22 22 22 22 22 21 
