71
15
23 23 23 23 23 23 23 23 23 23 23 23 23 23 23 23 23 23 23 23 23 23 23 23 23 23 23 23 23 24 24 23 23 23 23 23 23 23 23 23 23 23 23 23 23 23 23 23 23 23 23 24 21 21 23 23 23 23 23 23 23 23 23 23 23 23 23 23 0 0 0 
23 23 0 0 0 0 0 0 0 0 0 23 23 0 0 0 0 0 0 0 0 0 0 0 23 23 23 23 23 24 24 24 23 23 23 23 0 23 24 24 23 23 0 23 23 23 23 23 23 23 23 23 24 32 23 23 23 23 23 0 0 0 0 0 0 0 0 23 23 0 0 
23 23 23 0 0 0 0 0 0 0 0 0 23 23 23 23 23 23 0 0 0 0 0 0 0 0 0 0 23 23 23 23 23 0 0 0 0 0 23 24 23 0 23 23 0 0 23 23 0 0 0 0 23 23 23 23 23 0 0 0 23 0 0 0 0 0 0 0 23 23 0 
23 23 23 23 23 23 0 0 0 0 0 0 0 0 23 23 23 23 23 23 0 0 0 0 0 0 0 0 23 23 0 23 23 0 0 0 0 0 23 23 23 0 0 0 0 0 0 0 0 0 0 0 0 23 23 23 0 0 0 0 23 23 23 0 0 0 0 0 0 23 23 
7 0 0 0 0 23 23 23 23 23 0 0 0 0 0 0 0 23 23 23 23 0 0 0 0 0 0 0 0 0 0 23 23 0 0 0 0 0 23 23 0 0 0 0 0 0 0 0 0 0 0 0 0 0 0 0 0 0 0 23 0 0 23 23 0 0 0 0 0 0 23 
7 0 0 0 0 0 23 23 23 0 0 0 0 23 23 0 0 0 23 23 23 23 0 0 0 0 0 0 0 0 0 23 0 0 0 0 0 0 23 0 0 0 0 0 0 0 0 23 23 23 23 23 23 23 0 0 0 0 0 0 0 0 0 23 23 0 0 0 0 0 23 
23 23 23 23 0 0 0 0 0 0 0 23 23 23 0 0 0 0 0 23 23 23 23 0 0 0 0 0 0 0 0 23 0 0 0 0 0 0 23 0 0 0 0 0 0 0 23 23 23 0 0 0 0 23 23 0 0 0 0 0 0 0 0 0 23 0 0 0 0 23 23 
23 23 23 23 23 0 0 0 0 0 23 23 0 0 0 0 0 0 0 0 0 23 23 23 0 0 0 0 0 0 0 23 0 0 0 0 0 0 0 0 0 0 0 0 23 23 23 23 23 0 0 0 0 0 23 23 23 23 23 0 0 0 0 0 23 23 0 0 0 0 23 
21 24 24 23 23 23 0 0 0 23 23 0 0 0 0 23 23 23 0 0 0 0 0 0 0 0 0 0 0 0 0 0 0 0 0 0 0 0 0 0 0 0 23 23 23 23 23 0 0 0 0 0 0 0 0 0 0 0 0 23 0 0 0 0 6 21 23 0 0 0 23 
21 24 23 23 0 23 23 23 23 23 0 0 0 0 0 23 21 21 23 0 0 0 0 0 0 0 23 0 0 0 0 0 0 0 0 0 0 0 0 0 0 0 0 0 0 0 0 0 0 0 0 23 0 0 0 0 0 0 0 0 0 0 0 0 6 21 21 24 0 0 23 
21 21 23 0 0 0 23 23 23 0 0 0 0 0 0 23 23 23 23 0 0 0 0 0 0 0 0 0 0 0 0 0 0 0 0 0 0 0 0 0 0 0 0 0 0 0 0 0 0 0 23 23 0 0 0 0 0 0 23 23 23 23 27 22 22 21 21 21 24 24 23 
21 21 24 0 0 0 0 0 0 0 0 23 23 23 0 0 23 23 23 0 0 23 23 0 0 23 23 0 0 0 0 0 0 0 0 0 0 0 0 0 23 23 0 0 23 23 0 0 0 0 23 23 23 0 0 0 0 24 23 23 23 23 23 23 23 23 21 21 21 21 21 
21 21 21 23 23 0 0 0 0 0 23 24 24 23 0 0 0 0 0 0 23 23 23 23 23 23 23 23 0 0 0 0 0 0 0 0 0 0 0 23 23 23 23 23 23 23 23 0 0 23 23 21 21 0 0 0 0 5 0 0 0 0 0 0 0 23 24 21 21 21 21 
21 21 33 24 23 23 0 0 0 0 23 21 21 24 23 23 23 23 0 0 23 23 23 23 24 24 23 23 23 23 0 0 0 0 0 0 0 0 23 23 24 24 23 23 23 23 23 23 23 23 23 21 23 0 24 24 21 21 0 0 0 0 0 0 0 0 23 24 24 23 23 
21 21 21 24 23 23 23 23 23 23 23 21 21 21 23 23 23 23 23 23 23 23 21 24 24 24 24 23 23 23 23 23 23 23 23 23 23 23 23 24 24 24 23 23 23 23 23 23 23 23 23 23 23 23 23 21 23 23 23 23 23 23 23 23 23 23 23 23 23 23 23 
