91
24
23 23 23 23 23 23 23 23 23 23 23 23 23 23 23 23 23 23 23 23 23 23 23 23 23 23 23 23 23 23 23 23 23 23 23 23 23 23 23 0 0 23 23 0 0 23 23 23 0 23 23 23 23 23 23 23 23 23 23 23 23 23 23 23 23 23 23 23 23 23 23 23 23 23 23 23 23 23 23 23 23 23 23 23 23 23 23 23 23 23 23 
23 23 0 0 0 0 0 0 0 0 0 0 0 23 23 23 23 23 23 23 0 0 23 23 23 23 0 23 23 23 23 0 23 23 23 23 23 23 23 0 0 23 23 23 23 23 23 23 23 23 23 0 0 0 0 0 0 0 0 0 0 0 0 23 23 23 23 23 23 23 23 23 23 23 23 23 0 0 0 0 0 0 23 23 23 23 23 23 23 23 23 
23 23 0 23 23 23 0 0 0 0 0 0 0 23 23 23 23 0 0 0 0 0 0 0 0 0 0 0 0 23 0 0 23 23 23 0 23 23 23 23 0 0 0 23 23 23 23 0 0 0 0 0 0 0 0 0 0 0 0 0 0 0 0 0 0 23 23 23 23 23 23 23 23 23 23 0 0 0 0 0 0 0 0 0 0 0 23 23 23 23 23 
23 0 0 23 23 23 23 0 0 0 0 0 0 0 23 23 0 0 0 0 0 0 0 0 0 0 0 0 0 0 0 0 0 23 23 23 23 23 23 23 23 23 0 0 0 0 0 0 0 0 0 23 0 0 23 23 23 23 23 0 0 0 0 0 0 0 0 0 23 23 23 23 23 0 0 0 0 0 0 0 0 0 0 23 0 0 0 23 23 23 23 
23 0 0 0 0 23 23 23 23 0 0 0 0 0 23 23 0 0 0 0 0 0 0 0 0 0 0 0 0 0 0 0 0 23 23 0 0 0 0 23 23 23 23 0 0 0 0 0 0 23 23 23 0 0 0 0 23 0 23 23 23 23 23 0 0 0 0 0 23 23 23 23 23 0 0 0 0 0 0 0 23 23 23 23 23 0 0 23 23 23 23 
7 0 0 0 0 0 0 23 23 23 0 0 0 0 0 23 0 0 0 0 0 0 0 0 0 0 0 0 0 0 0 0 0 23 0 0 0 0 0 0 0 23 23 0 0 0 0 23 23 23 23 23 0 0 0 0 23 23 23 23 23 0 23 0 0 0 0 0 23 23 23 0 0 0 0 0 0 23 23 23 23 23 23 0 0 0 0 0 23 23 23 
7 0 0 0 0 0 0 0 23 23 23 0 0 0 0 23 0 0 0 23 23 23 23 23 0 0 0 0 0 0 0 0 0 23 0 0 0 0 0 0 0 0 23 0 0 0 0 23 23 23 23 23 23 0 0 0 0 23 23 23 0 23 23 0 0 0 0 0 23 23 23 0 0 0 0 23 23 23 23 23 23 0 0 0 0 0 0 0 0 23 23 
22 22 4 0 0 0 0 0 23 23 23 23 0 0 0 0 0 0 0 23 0 23 23 23 0 0 23 23 0 0 0 0 0 23 0 0 0 0 0 0 0 0 0 0 0 0 0 0 0 0 0 0 0 0 0 0 0 0 23 23 23 23 0 0 0 0 0 0 0 23 23 0 0 0 0 0 23 23 23 23 23 0 0 0 0 0 23 0 0 23 23 
23 23 0 0 0 0 0 0 23 23 23 23 0 0 0 0 0 0 23 0 0 23 23 0 0 0 23 23 23 23 0 0 0 0 0 0 0 0 0 0 0 0 0 0 0 0 0 0 0 0 0 0 0 0 0 0 0 0 23 23 23 0 0 0 0 0 0 0 0 0 0 0 0 0 0 0 23 23 23 23 0 0 0 0 0 0 0 23 23 23 23 
23 23 23 0 0 0 0 0 23 23 23 23 23 0 0 0 0 23 23 0 0 0 23 0 0 0 0 23 23 23 23 0 0 0 0 0 0 0 0 0 0 0 23 23 23 0 0 0 0 0 0 0 0 0 0 0 0 0 0 0 0 0 0 0 0 0 0 0 0 0 0 0 0 0 0 0 0 0 0 0 0 0 0 0 0 0 0 0 23 23 23 
23 23 23 0 0 0 0 0 0 23 23 23 23 0 23 23 23 23 23 0 0 0 23 0 0 0 0 0 0 23 23 23 23 23 23 0 0 0 0 0 23 23 23 23 0 0 0 0 0 0 0 0 23 23 23 0 0 0 0 0 0 0 0 0 0 0 0 0 0 0 0 0 0 0 0 0 0 0 0 0 0 0 0 0 0 0 0 0 0 23 23 
23 23 23 23 0 0 0 0 0 23 23 23 23 23 23 23 23 23 0 0 0 0 0 0 0 0 0 0 0 0 0 23 0 0 23 23 23 0 0 23 23 23 23 0 0 0 0 23 23 23 0 0 0 0 23 0 0 0 0 0 0 0 0 0 0 0 0 0 0 0 0 0 23 23 0 0 0 0 0 0 0 0 0 23 0 0 0 0 0 23 23 
23 23 23 23 0 0 0 0 0 23 23 23 23 23 0 23 23 0 0 0 0 0 0 0 0 0 0 0 0 0 0 0 0 0 0 0 23 23 23 23 23 23 0 0 0 0 23 23 23 23 23 23 23 0 23 23 23 23 0 0 0 0 0 0 0 0 23 0 0 0 0 0 0 23 23 0 0 0 0 0 0 0 0 23 23 23 0 0 0 23 23 
23 23 23 23 23 0 0 0 0 23 23 23 23 0 0 0 0 0 0 0 0 0 0 0 0 0 0 0 0 0 0 0 0 0 0 0 0 23 23 23 0 0 0 0 0 0 23 23 23 23 23 23 23 23 23 23 23 23 23 23 23 0 0 0 0 23 23 23 23 0 0 0 0 0 23 23 0 0 0 0 0 0 23 23 23 23 23 0 0 0 23 
23 23 23 23 23 0 0 0 0 0 23 23 23 23 0 0 0 0 0 0 0 0 0 0 0 0 0 0 0 23 0 0 0 0 0 0 0 0 23 23 0 0 0 0 23 23 23 23 23 0 23 23 0 0 0 0 6 21 21 23 23 0 0 23 0 23 0 0 0 0 0 0 0 0 0 23 0 0 0 23 23 23 23 23 23 0 23 0 0 0 23 
23 23 23 23 23 23 0 0 0 0 23 23 23 0 0 0 0 0 0 0 0 0 0 0 0 0 23 23 23 23 0 0 0 0 0 0 0 0 23 23 0 0 0 0 23 23 23 23 23 23 0 0 0 0 0 0 6 21 21 21 23 23 23 0 23 23 0 0 0 0 0 23 0 0 0 23 23 0 0 0 23 23 23 23 23 0 23 23 23 23 23 
23 23 23 23 23 23 0 0 0 0 0 0 0 0 0 0 0 0 0 0 0 0 0 0 0 23 23 23 23 23 0 0 0 0 0 0 0 0 0 0 0 0 0 23 23 23 23 23 23 0 0 0 0 0 22 22 22 24 21 21 21 23 23 23 23 0 0 0 0 23 23 23 23 0 0 23 23 0 0 0 0 0 23 23 0 0 23 23 23 23 23 
23 23 23 23 23 23 23 0 0 0 0 0 0 0 0 0 0 0 0 0 0 0 0 0 23 23 23 23 23 0 0 0 0 0 23 23 23 23 0 0 0 0 23 23 0 0 0 0 0 0 0 0 23 23 23 23 23 24 24 21 21 21 23 23 23 23 0 0 0 0 23 23 0 0 0 23 23 0 0 23 0 0 0 0 0 0 0 23 23 23 23 
23 23 23 23 23 23 23 23 23 23 23 23 23 23 23 23 23 23 23 23 0 0 0 0 23 23 23 23 23 23 23 0 0 23 23 23 23 23 23 0 0 23 23 0 0 0 0 0 0 0 0 0 23 23 23 23 23 23 24 24 21 21 21 23 23 23 0 23 23 0 0 0 0 0 23 23 0 0 0 23 0 0 0 0 23 0 23 23 23 23 23 
23 23 23 23 23 23 23 23 23 23 23 0 0 0 0 0 0 0 0 0 0 0 0 23 23 23 23 23 23 23 23 23 23 23 23 23 23 23 0 0 0 0 0 0 0 0 0 0 0 0 0 23 23 23 23 23 23 23 23 24 24 21 21 21 23 23 23 23 23 23 0 0 0 23 23 0 0 0 23 23 0 23 23 23 23 23 23 23 23 23 23 
23 23 0 23 23 23 23 23 0 0 0 0 0 0 0 0 0 0 0 0 0 0 0 23 23 23 23 23 23 23 23 23 23 23 23 23 23 23 23 23 0 0 0 0 0 0 0 0 0 0 0 23 23 23 23 23 23 23 23 24 24 24 21 21 21 23 23 23 23 23 23 0 23 23 0 0 23 23 23 23 23 23 23 23 23 23 23 23 23 23 23 
23 0 0 0 0 0 0 0 0 0 0 0 0 0 0 0 0 0 0 0 0 0 23 23 23 23 23 23 23 23 23 23 23 23 23 23 23 23 23 23 23 0 0 23 23 23 0 0 0 0 23 23 23 23 23 23 23 23 23 23 24 24 24 21 21 21 23 23 23 23 23 0 23 23 0 0 0 23 23 23 23 23 23 23 23 23 23 23 23 23 23 
23 0 0 0 0 0 0 0 0 0 23 23 23 23 23 23 0 0 0 0 0 0 23 23 23 23 23 23 23 23 23 23 23 23 23 23 23 23 23 23 23 23 23 23 23 23 23 23 23 23 23 23 23 23 23 23 23 23 23 23 23 23 23 23 21 21 21 23 23 23 23 23 23 23 23 23 23 23 23 23 23 23 23 23 23 23 23 23 23 23 23 
23 23 23 23 23 23 23 23 23 23 23 23 23 23 23 23 23 23 23 23 23 23 23 23 23 23 23 23 23 23 23 23 23 23 23 23 23 23 23 23 23 23 23 23 23 23 23 23 23 23 23 23 23 23 23 23 23 23 23 23 23 23 23 23 23 21 21 23 23 23 23 23 23 23 23 23 23 23 23 23 23 23 23 23 23 23 23 23 23 23 23 
